1111111111111111111111111111111111
10C000E00000000C00000C000000000001
1111010100100011111001000000010101
1001010010101010001001000000010101
1111010100100011111001000000010101
1001010010101010001001000000010101
1111010100100011111001000000010101
1001010010101010001001000000010101
100100000C00P0100010000000000000C1
1111111111111111111111111111111111
