1111111111111111111111111111
1CCCCCCCCCCCC11CCCCCCCCCCCC1
1C1111C11111C11C11111C1111C1
1C1111C11111C11C11111C1111C1
1C1111C11111C11C11111C1111C1
1CCCCCCCCCCCCCCCCCCCCCCCCCC1
111111C11111011011111C111111
111111C11111011011111C111111
111111C10000000000001C111111
111111C101100CC001101C111111
1C0000C001CC1111CC000C0000E1
111111C10111111111101C111111
111111C10000000000001C111111
111111C10111111111101C111111
1CCCCCCCCCCCC11CCCCCCCCCCCC1
1C1111C11111C11C11111C1111C1
1C1111C11111C11C11111C1111C1
111C11C11C11111111C11C11C111
1CCCCCCCCCCCCCPCCCCCCCCCCCC1
1111111111111111111111111111
