111111111111111111111111111111
1P0000000000000000000000000001
101111111111110000000011100001
100000000000000C1100000000CC01
100000000000000000110000000001
100000000001000000000100000001
101111110001110110C1001C00CC01
100000000000000000000111110001
101111110000100000000100000001
101E000100001000000000000000C1
10100C0100001001111111100000C1
1010000100001000000000000000C1
1010000100001C1111111100CC0001
100000C0000100CCCCC000000C0001
1000001100001001100001100000C1
100000110000100000000000000001
1C00000000C10000000000000000C1
1111111111111111111111111110C1
101010101010111111111111111111
111111111111111111111111111111
