111111111111111111111111111
100000000000000000000000011
100010001110001110011110011
100110000010000010000010011
100010000100000100000100011
100010000010000010P01000011
100111001110001110C10000011
11E000000000000000000001111
111111111111111111111111111
