11111111111111111111111111111111111111111
1CCCCCCCCCCCCCCCCC11111111111111111111111
11111111111111111C11111111111111111111111
11111111111111111C11111111111111111111111
11111111111111111C11111111111111111111111
1CCCCCCCCCCC11111C11111111111111111111111
11111111111C11111C11111111111111111111111
11111111111C11111C11111111111111111111111
11111111111C11111C11111111111111111111111
1CCCCPCCCCCCCCCCCCCCCCCCCCCCCCCCCCCCCCCE1
11C11111C11111C111111111C1111111111111111
1CC11111C11111C111111111C1111111111111111
11111111C11111C111111111C1111111111111111
11111111C11111C111111111C1111111111111111
11111111C11111C111111111C1111111111111111
1CCCCCCCC11111C111111111C1111111111111111
11111111111111C111111111C1111111111111111
1CCCCCCCCCCCCCC111111111C1111111111111111
11111111111111111111111111111111111111111
